111111111111
1000000100P1
111111110001
10000C100011
111110101111

1E0000000001
111111111111


sprite sur map gigantesque
verif sur les textures si null
