11111111111111
10000001000001
10C00001000001
10000001111111
1000000E000001
10000000000001
100000P0000001
11111111111111
