1111111111111111111111111
10000001000001PC010000001
10C0000100C001000100C0001
1000000111110101111111101
1000000E0000010C000000001
1000000000000111111100001
1000000000000000000000C01
1111111111111111111111111
