11111111111
1001000C111
10000011111
11111100P01
10000E00h01
11111111111