11111111
1P0000C1
11100001
1C000001
11111001
1E000001
11111111
