11111111111
100P00C0101
10000000111
11111E00001
10000000001
11111111111
